10 8 64
CECCC.C.CC
..C...C.CC
C...C.....
.CCCCC..CC
...CC...C.
..CC...CC.
..........
...CS.CCCC
