12 9 64
.........E..
............
.....C......
...CCCC.....
....C.......
............
............
............
....S.......