14 10 64
CECCC.C.CCCCCC
..C...C.CC....
C...C.........
.CCCCC..CC....
...CC...C.....
..CC...CC.....
..............
...CC.CCCC....
..............
......S.......
