14 11 64
CECCC.C....CCC
..C...C.C.C...
....C.......CC
.CCCCC.CCC....
...CC...C.....
CC.C..CCC.CC..
..............
CC.CC.CCCCCC.C
..........C...
CCC.CCSCC...CC
C...CC.CCCC.CC