14 11 64
CECCC.C....CCC
C.....CCC.C...
CCC.C.......CC
C.CCCC.CCC....
...CC...C.....
CC.C..CCC.CC..
..............
CC.CC.CCCCCC.C
..........C...
CCC.CC.CC...CC
C...CCSCCCC.CC