10 8 64
..........
.CCCCCCCC.
.C......C.
.C......C.
.C......C.
.C......C.
.CCCCCCCC.
..........
