10 8 64
C.CCC.C.CC
..C...C.CC
C...C.....
.CCCCC..CC
...CC...C.
..CC...CC.
..E.......
...CS.CCCC
