10 8 64
C.........
..........
.....C....
...CCCC...
....C.....
..........
..........
..........
