80 54
................................................................................
.CCCCCCCCCCCCCCCCCCCCCCCCCCCCCCCCCCCCCCCCCCCCCCCCCCCCCCCCCCCCCCCCCCCCCCCCCCCCCC.
.C..............C.....................C.......................................C.
.C..............C.....................C.......................................C.
.C..............C.....................C.......................................C.
.C..............C.....................C.......................................C.
.C..............C...............C.....C.......................................C.
.C..............C..............CC.....C.......................................C.
.C..............C.............CC......C.......................................C.
.C..............C.............C.......C.......................................C.
.C..............C............CC.......C.......................................C.
.C..............C...........CC........C.......................................C.
.C..............C...........C.........C.......................................C.
.C.........................CC.........C.......................................C.
.C.........................C..........C.......................................C.
.C.........................C..........C.......................................C.
.C................CCCCCCCCCCCCCCCCCCCCC.......................................C.
.C....................................C.......................................C.
.C....................................C.......................................C.
.C....................................C.......................................C.
.CCCCCCCCCCCCCCC......................C.......................................C.
.C....................................C.......................................C.
.C.............C......................C.......................................C.
.C.............C......................C.......................................C.
.C.............C......................C.......................................C.
.C.............C......................C.......................................C.
.C.............C......................C.......................................C.
.C.............C......................C.......................................C.
.CCCCCCCCCCCCCCCCCCCCCCCCCCCCCCCCCCCCCCCCCCCCC....CCCCCCCCCCCCCCCCCCCCCCCCCCCCC.
.C............................................................................C.
.C............................................................................C.
.C................................................CCCCC.......................C.
.C............................................................................C.
.C..................................................................C.........C.
.C..................................................................C.........C.
.C.....................CCCCCC.......................................C.........C.
.C.....................C............................................C.........C.
.C.....................C............................................C.........C.
.C.....................C............................................C.........C.
.C.....................C............................................C.........C.
.C.....................C....C.......................................C.........C.
.C.....................C....C.......................................C.........C.
.C.....................C....C.......................................C.........C.
.C.....................C....C.......................................C.........C.
.C.....................C....C.......................................C.........C.
.C.....................C....CCCCCCCCCCCCCCCCCCCCCCCCCCCCCCCCCCCCC...C.........C.
.C.....................C....C.................................................C.
.C.....................CCCCCC.................................................C.
.C............................................................................C.
.C.........................C........................C.........................C.
.C..........................C......................C..........................C.
.C............................C...................C...........................C.
.CCCCCCCCCCCCCCCCCCCCCCCCCCCCCCCCCCCCCCCCCCCCCCCCCCCCCCCCCCCCCCCCCCCCCCCCCCCCCC.
................................................................................